111111111111111111111111111111111111
10000000000000C000000000000000000C01
101111111111111111111111111111111111
101111111111111111111111111111111111
101111111111111111111111111111111111
101111111111111111111111111111111111
101111111111111111111111111111111111
101111111111111111111111111111111111
1000C000000000000000C000000000000001
1111111111111111111111111111111111C1
111111111111111111111111111111111101
11111111111111111111111111E1111111C1
1111111111111111111111111111111111C1
1111111111111111111111111111111111C1
111111111111111111111111111111111101
111111111111111111111111111111111101
1P0000000C0C0C0C00000000000000000001
111111111111111111111111111111111111