111111111111111111111111111111111111
100000000000000000000000000000000001
101111111111111111111111111111111111
1011C11CCCC1111111111111111111111111
1011C11000C1111111111111111111111111
1011C11CCCC1111111111111111111111111
1011C11000C1111111111111111111111111
1011C11CCCC1111111111111111111111111
100000000000000000000000000000000001
111111111111111111111111111111111101
111111111111111111111111111111111101
111111111111111111C1P11111E111111101
111111111111111111111111111111111101
111111111111111111111111111111111101
111111111111111111111111111111111101
111111111111111111111111111111111101
100000000000000000000000000000000001
111111111111111111111111111111111111